tilesheet=castletiles
size=27 15
region=castle
poi=2 2 DOOR 2 2 0 castle_1
poi=3 6 DOOR 2 6 0 castle_1
poi=6 6 DOOR 6 7 0 castle_1
poi=15 7 DOOR 15 7 0 castle_3
poi=5 13 DOOR 6 12 0 castle_3
poi=2 13 DOOR 2 12 0 castle_3
BEGIN_BODY
133131313131313131313131313131313131313131313131313114
220000000000000000000000000000000000000000000000000020
22001c000000000000000000000000000000000000000000000020
220000000000000000000000000000000000000000000000000020
231111111111111111111111111111111111120000101111111124
133131311413313114133131313131313114220000303131313114
2200001c20221c0020220000000000000020220000000000000020
2200000020220000202200000000002c0020220000000000000020
220000002022000020220000000000000020220000000000000020
220000102422000020231112000010111124231111111200001024
220000201332000020133132000030313131313131313200003014
220000202200000020220000000000000000000000000000000020
220000202200000020220000000000000000000000000000000020
22002c20222c000020220000000000000010120000000000000020
231111242311111124231111111111111124231111111111111124
