tilesheet=castletiles
size=27 15
region=castle
poi=11 12 DOOR 6 12 0 castle_4
poi=15 7 DOOR 15 7 0 castle_2
poi=6 12 DOOR 5 13 0 castle_2
poi=2 12 DOOR 2 13 0 castle_2
BEGIN_BODY
133131313131313131313131313131313131313131313131313114
220000000000000000000000000000000000000000000000000020
220000000000000000000000000000000000000000000000000020
220000000000000000000000000000000000000000000000000020
220000000000000010111111111111111111120000000000000020
220000000000000030313131313131313114220000000000000020
220000000000000000000000000000000020220000000000000020
2200000000000000000000000000001c0020220000000000000020
220000000000000000000000000000000020220000000000000020
231111111111111111111111111111111124220000000000000020
133131313131313114133131313131313131320000000000000020
220000000000000020220000000000000000000000000000000020
22001c0000001c002022002c001a00000000000000000000000020
220000000000000020220000002a00000000000000000000000020
231111111111111124231111111111111111111111111111111124
