tilesheet=castletiles
size=9 20
region=castle
poi=4 17 DOOR 15 17 0 castle_b1
poi=4 2 DOOR 15 2 0 castle_b1
poi=5 7 TREADLE 0 0 0 fmn_hero_become_pumpkin
poi=5 8 TREADLE 0 0 0 fmn_hero_become_pumpkin
BEGIN_BODY
212121212121212121
212113313131311421
2121221a2c00002021
1331322a0000002021
220010111112002021
220020212122002021
220020133132002021
220020220002002021
220020220002002021
220020220010112421
220020220030311421
220020220000002021
220020231200002021
220030142312002021
220000202122002021
220000303132002021
221b00000000002021
222a00002c00002021
231111111111112421
212121212121212121
