tilesheet=castletiles
size=27 25
region=castle
poi=19 12 SPRITE 4 0 0 tablesaw
poi=23 21 SPRITE 2 0 1 stompbox
poi=20 20 SPRITE 2 1 0 spikyfence
poi=26 0 EDGE_DOOR 255 221 0 home
poi=12 21 SPRITE 4 180 0 tablesaw
poi=11 22 SPRITE 4 0 0 tablesaw
poi=15 2 DOOR 4 2 0 castle_b2
poi=15 17 DOOR 4 17 0 castle_b2
poi=11 3 DOOR 24 2 0 castle_1
poi=7 11 DOOR 13 12 0 castle_1
poi=12 12 TREADLE 0 0 0 fmn_hero_become_pumpkin
poi=13 12 TREADLE 0 0 0 fmn_hero_become_pumpkin
poi=14 13 TREADLE 0 0 0 fmn_hero_become_pumpkin
BEGIN_BODY
212121212121212121212121212121212121133131313131313114
211331313131313114133131313131313114220000000000000020
212200000000000020221a000000001c0020220033333333330020
212200101111120020222a2c000000000020220033000000330020
212200202121220020231111111111111124220033003300330020
212200202121220030313114133131313114220000003300330020
212200303114220000000020220000000030323333333300330020
212200001b20231111120030320010120000000000000000330020
212200002a20212121220000000020231111111111111111120020
212311111124212121231111111124212121212121133114220020
212113313131313114133131313131313131313131321a20220020
212122000000002c20220000000000000000000000002a20220020
212122000010111124220000020200000010120304040530320020
212122000020212121220000000002000020220000000000000020
212122000020212121231112000010111124231111111112001024
211332000020212121133132000030313114212121212122002021
212200000020212121221a00000000000020212121212122002021
212200000020212121222a000000001c0020211331313132002021
212200001024212121220000000000000020212200000000002021
212200002021212121231111111111111124212200101111112421
212200003031313131313131313131313131313200201331311421
212200000000000000000000030404050000000000202200003031
212200000000000000000003040405000000000000202200000000
212311111111111111111111111111111111111111242311111111
212121212121212121212121212121212121212121212121212121
