tilesheet=castletiles
size=9 20
region=castle
poi=4 17 DOOR 15 17 0 castle_b1
poi=4 2 DOOR 15 2 0 castle_b1
BEGIN_BODY
212121212121212121
212113313131311421
2121221a2c00002021
2121222a0000002021
212123111200002021
212121212200002021
211331313200002021
212200000000002021
212200000000002021
212200001011112421
212200003031311421
212200000000002021
212200000000002021
212311111112002021
212121212122002021
212113313132002021
212122000000002021
212122002c00002021
212123111111112421
212121212121212121
