tilesheet=castletiles
size=36 15
region=castle
poi=24 6 SPRITE 0 0 0 werewolf
poi=6 12 DOOR 11 12 0 castle_3
BEGIN_BODY
133131313131313131313131313131313131313131313131313131313131313131313114
220000000000000000000000000000000000000000000000000000000000000000000020
220000000000000000000000000000000000000000000000000000000000000000000020
220000000000000010111200000000000000000000000000000000000000151617000020
220000000000000020212311111111111111111111111111111111120000252627000020
220000000000000020133131313131313114262626262626262626220000252627000020
220000000000000020220000151616383830262626262626262626220000252627000020
22000000000000002022001a25262638382626262626262626262622001a2526271a0020
22000000000000002022002a25261838381026262626262626262622002a2526272a0020
220000101111111124220000252627000020262626262626262626220000252627000020
220000303131313114220000252627000030313131313131313131320000252627000020
220000000000000020220000252628161616161616161616161616161616292627000020
2200000000001c0020220000252626262626262626262626262626262626262627000020
220000000000000020220000353636363636363636363636363636363636363637000020
231111111111111124231111111111111111111111111111111111111111111111111124
