tilesheet=castletiles
size=27 20
region=castle
poi=1 7 SPRITE 7 0 0 tablesaw
poi=4 13 SPRITE 0 0 150 firenozzle_n
poi=13 3 SPRITE 0 0 150 firenozzle_n
poi=12 1 SPRITE 0 1 150 firenozzle_s
poi=14 1 SPRITE 0 1 150 firenozzle_s
poi=19 12 SPRITE 7 0 0 tablesaw
poi=19 7 SPRITE 7 0 0 tablesaw
poi=13 19 DOOR 47 41 0 home
poi=13 17 START 0 0 0 
BEGIN_BODY
133131311413313131313131313131313131313131311421212121
22002c002022000000000000000000000000000000002021212121
2200000020222c0000000000000000000000000000002021212121
220000002022000000000000000000000000000000002021212121
220000002023111111111111111111111111120000002021212121
220000002021212121133131313131313114220000002021212121
220000003031313114221a00000000000020220000003031313114
220101010101010120222a00001c00000020220101010101010120
231111111112000020220000333333000020231111111200000020
212121212122000020220000000000000020212121212200000020
133131313132000020220000000000000020212121212200000020
220000000000000020220000330033000020133131313200000020
220000000000000020220000000000000020220101010101010120
220000000000000020220033000000330020220000001011111124
220000101111111124220000003300000020220000002021212121
220000303131313114220000001a00000020220000003031313114
220000000000000030322b00002a00001b30320000000000000020
220000000000000000002a00000000002a00000000000000000020
220000000000000000000000000000000000000000000000000020
231111111111111111111111120010111111111111111111111124
