tilesheet=castletiles
size=27 15
region=castle
poi=1 3 DOOR 2 2 0 castle_1
poi=3 6 DOOR 2 6 0 castle_1
poi=6 6 DOOR 6 7 0 castle_1
poi=12 7 DOOR 15 7 0 castle_3
poi=5 13 DOOR 6 12 0 castle_3
poi=2 13 DOOR 2 12 0 castle_3
poi=4 3 SPRITE 0 0 150 firenozzle_n
poi=10 3 SPRITE 7 0 0 tablesaw
poi=15 1 SPRITE 0 0 220 firenozzle_s
poi=19 7 SPRITE 4 0 0 tablesaw
poi=20 12 SPRITE 20 1 0 spikyfence
poi=24 13 SPRITE 20 0 1 stompbox
poi=13 11 SPRITE 0 0 0 pushbox
poi=14 11 SPRITE 0 0 0 pushbox
BEGIN_BODY
133131313131313131313131142113313131313131313131313114
220000000000000000000000303132000000000000000000000020
2200101200000000000000000000330000000000001a2b00000020
221c202200000000101203040404040405101200002a2a00000020
231124231111111124231111111111111124220000101200000020
133131311413313114211331313114212121220000202200000020
2200001c20221c0020212200000020212121220000303200000020
2200000020220000202122002c0020212121220304040500000020
220000002022000020212200000020212121220000101200000020
220000102422000020212311120020212121231200202200001024
220000201332000020211331320030142121212200202200003014
220000202200000020212200000000303131313200202312000020
220000202200000020212200333300000000000000202122000020
22002c20222c000020212200000000000010111111242122000020
231111242311111124212311111111111124212121212123111124
