tilesheet=mtntiles
size=27 20
region=caves
poi=6 2 DOOR 6 2 0 caves_1
poi=3 12 DOOR 3 12 0 caves_1
poi=11 8 SPRITE 6 1 0 spikyfence
poi=14 6 SPRITE 6 0 1 stompbox
poi=15 6 SPRITE 7 1 0 spikyfence
poi=14 8 SPRITE 7 0 1 treadle
poi=25 1 SPRITE 0 0 0 pushbox
BEGIN_BODY
212121211331313131313114133131313114212113313114133114
212121212206030102030620220406010020211332000130320120
212121212204730310120430320210120320133200050104030420
212121212203020120220000030220220020220501000501020020
212121212311111124231111111124220020220001101111120220
212121212121133131313131141331320030320302303114220020
212121212121220600040605202201030005010201020530320320
211331313131320310111201202234333434343333330033040220
212202040003000020212203202203010703050101050503001024
212203101111111124212205202311111111111111111111112421
212200303114212121133205303131313131313131313131313114
212207030320212121220005020100040301030400000502010020
212312730220212121220207000503030002020202010504060120
212122010020212121220103010701020002070000000201020420
212123111124212121231111111111111111120104040303000120
313131313131313131313131313131313131320401000201030020
505151515151515200000404020100000104010104070100010020
604353445443446204040100060200050503010101010001010020
707171717171717204040107000607030400010100070204000020
111111111111111111111111111111111111111111111111111124
