tilesheet=mtntiles
size=27 20
region=caves
poi=13 19 DOOR 20 5 0 mountains
poi=13 1 SPRITE 4 0 0 treasure
poi=5 11 SPRITE 2 8 0 fire
poi=5 12 SPRITE 2 8 0 fire
poi=5 13 SPRITE 2 8 0 fire
poi=6 7 SPRITE 2 8 0 fire
poi=3 17 SPRITE 3 0 1 stompbox
poi=24 12 SPRITE 4 0 1 stompbox
poi=15 8 SPRITE 3 1 0 spikyfence
poi=20 2 SPRITE 4 1 0 spikyfence
poi=23 11 SPRITE 5 0 0 firenozzle_s
poi=19 12 SPRITE 5 1 0 treadle
poi=22 6 SPRITE 0 0 0 pushbox
poi=3 12 DOOR 3 12 0 caves_2
poi=6 2 DOOR 6 2 0 caves_2
BEGIN_BODY
212121212121212121133131313131313114212121212121212121
212113313131311421220304040000050730313131313114212121
211332020700632021220304030001020701050305020230142121
212204010000032021220703000502050110111112020205301421
212207010302102421231111111111111124212122010400052021
212200040101202121212121212121212121212122040501022021
212202010003301421212121212121212121212122040001062021
212312010001053031313131313131313131313132050006022021
212123111112020604030301010704000702070101010304102421
212121212123111111111204101112021011111111111111242121
211331313131142121212200303132022021211331313131142121
212204040402303131313202000000002021133206000106301421
212203630202010506030106101112003031320104030002002021
212200000001101111111202202122030402020304000502032021
212311111111242121212205202122021011111112011011112421
211331313131142121133200303132003014212122012021212121
212205050001303131320003050105060230313132022021212121
212203000203000001010303000103030106000300042021212121
212200030104101111111111120110111111111111112421212121
212311111111242121212121220320212121212121212121212121
