tilesheet=bgtiles
size=18 10
region=cave
poi=1 1 DOOR 1 13 0 outermap
poi=4 7 START 0 0 0 
BEGIN_BODY
514242424242424242424242424242424253
603900000000000000000000000000000060
600000000000000000000000000000000060
600000000000000051530000000000000060
615253000000005162625300000000515263
617273000000007162627300000000717263
600000000000000071730000000000000060
600000000000000000000000000000000060
600000000000000000000000000000000060
714242424242424242424242424242424273
