tilesheet=bgtiles
size=45 25
region=forest
poi=0 24 EDGE_DOOR 255 231 0 home
poi=40 22 SPRITE 2 0 0 treasure
poi=3 12 START 0 0 0 
BEGIN_BODY
919191919191919191919191919191919191919191919191919191919191919191919191919191919191919191
9183a1a1a1a1a1a1a1a1a1a18483a1a1a1a1a1a1a1a18483a1a18483a1a1a1a1a1a1a1a1a1a1a1a1a1a1a18491
91920e0e0e0e0e0e0e0e0e0e90920e0e0e0e0e0e0e0e90920e0e90920e0e0e0e0e0e0e0e0e0e0e0e0e0e0e9091
91920e0e0e0e0e0e0e0e0e0e90920e0e0e0e0e0e0e0e90920e0e90920e0e0e0e0e0e0e0e0e0e0e0e0e0e0e9091
91920e808181818181820e0e909381818181820e0e0e90920e0e90920e0e80818181818181818181820e0e9091
91920ea0a1a1a1a184920e0e9083a1a1a1a1a20e0e0e90920e0e90920e0e9083a1a1a18483a1a1a1a20e0e9091
91920e0e5556565790920e0ea0a20e0e0e0e0e0e0e0e90920e0e90920e0e909255565790920e0e0e0e0e0e9091
91920e0e7576767790920e0e0e0e0e0e0e0e0e0e0e0e90920e0e90920e0e909265666790920e0e0e0e0e0e9091
91920e0e0e0e0e0e90920e0e0e0e0e0e0e0e0e0e0e0e90920e0e90920e0e909275767790920e0e0e0e0e0e9091
919381820e0e0e0e909381818181818181818181818194920e0e90920e0e90920e0e0e90920e0e808181819491
a1a1a1a20e0e0e0e9083a1a1a1a1a1a1a1a1a1a1a1a1a1a20e0e90920e0e90920e0e0e90920e0ea0a1a1a18491
0e0e0e0e0e0ea40e90920e0e0e0e0e0e0e0e0e0e0e0e0e0e0e0e90920e0e90920e0e0e90920e0e0e0e0e0e9091
0e0e0e0e0e0e0e0e90920e0e808245464646464646465646464790920e0e90920e0e0e90920e0e0e0e0e0e9091
0e0e0e0e0e0ea40e90920e0e90920e0e0e0e0e0e0e0e640e0e0e90920e0e90920e0e0e90920e0e0e0e0e0e9091
818181820e0e0e0e90920e0e90920e0e0e80820e0e0e640e0e0e90920e0e90920e0e0e9093818181820e0e9091
9183a1a20e0e0e0e90920e0e90920e0e0e90920e0e0e640e0e0ea0a20e0e90920e0e0e9083a1a1a1a20e0e9091
91920e0e0e0e0e0ea0a20e0e90920e0e0e90920e0e0e640e0e0e0e0e0e0e90920e0e0e90920e0e0e0e0e0e9091
91920e0e0e0e0e0e0e0e0e0e90920e0e0e90920e0e0e7546464646470e0e90920e0e0e90920e0e0e0e0e0e9091
91920e0e0e0e0e0e0e0e0e0e90920e0e0e90920e0e0e0e0e0e0e0e0e0e0e90920e0e0e90920e555656570e9091
91920e0e0e8081818181818194830e0e0e90920e0e80818181818181818194920e0e0e90920e656666670e9091
91920e0e0ea0a1a1a1a1a1a1a1a20e0e0e90920e0ea0a1a1a1a1a1a1a1a1a1a20e0e0e90920e757676770e9091
91920e0e0e0e0e0e0e0e0e0e0e0e0e0e0e90920e0e0e0e0e0e0e0e0e0e0e0e0e0e0e0e90920e0e0e0e0e0e9091
91920e0e0e0e0e0e0e0e0e0e0e0e0e0e0e90920e0e0e0e0e0e0e0e0e0e0e0e0e0e0e0e90920e0e0e0e0e0e9091
9193818181818181818181818181818181949381818181818181818181818181818181949381820e0e0e809491
919191919191919191919191919191919191919191919191919191919191919191919191919193818181949191
