tilesheet=bgtiles
size=72 60
region=home
poi=49 42 START 0 0 0 
poi=39 37 DOOR 4 4 0 tunnelhouse
poi=39 42 DOOR 4 4 0 westhouse
poi=47 37 DOOR 4 4 0 northhouse
poi=71 0 EDGE_DOOR 0 25 0 forest
poi=47 41 SPRITE 0 0 0 pushbox
poi=51 41 SPRITE 0 0 0 pushbox
BEGIN_BODY
c1c1c1c1c1c1c1c1c1c1c1c1c1c1c1c1c1c1c1c1b3d1d1d1b4c1c1c1c1c1c2656667c0c1c1c1b3d1d21d1d1ed0d1b4c1c1c1c1c1c1c1b3d1d1d1d1b4c1c1c1c1c1c1c1c1c1c1c1c1
c1c1c1c1c1c1b3d1d1d1d1d1d1d1d1d1d1b4c1c1c21d1d1dd0b4c1c1c1c1c2656667d0d1d1d1d21e1e1d1e1d1d1ed0d1d1d1d1d1d1d1d21d1d1d1dd0d1d1d1d1b4c1c1c1c1c1c1c1
c1c1b3d1d1d1d21d1d1e1d1d1e1e1d1e1ed0d1d1d21e1d1d1dc0c1c1c1c1c26566671d1e1e1e1d1d1d1d1d1d1d1d1e1d1d1d1d1d1e1e1e1d1e1d1d1e1e1d1e1ed0d1d1d1b4c1c1c1
c1b3d21d1d1d1d1d1d1d1d1e1d1d1d1e1d1d1d1e1f1d1d1e1dd0b4c1c1c1c26566671d1d1d1d1d1d1d1d1d1e1d1e1d1d1d1d1d1d1d1d1e1d1e1d1e1d1e1f1d1d1d1e1d1dd0b4c1c1
c1c21d1d1d1db0b1b1b21e1d1e1e1e1d1e1e1d1d1d1d1d1e1f1dc0c1c1c1c26566671d1d1e1d1d1d1f1d1d1f1e1d1e1e1e1d1d1d1d1f1d1f1d1d1d1d1d1f1e1d1d1f1e1d1ec0c1c1
d1d21d1e1d1ec0c1c1c21d1d1d1d1d1d1d1e1d1d1d1d1d1e1f1dc0b3d1d1d26566671d1e1d1e1e1e1d1e1e1e1d1d1d1d1d1f1d1e1d1d1e1d1e1e1d1e1d1f1d1d1e1d1d1d1dd0d1d1
1e1f1d1d1db0c4c1c1c21d1d1d1d1d1d1e1d1e1f1e1e1d1d1d1ec0c21d1f1d6566671d1e1d1d1e1d1d1f1d1d1d1e1d1d1d1d1e1d1e1d1f1d1d1d1e1d1d1f1e1f1e1d1d1d1e1f8082
1e1e1e1d1ec0c1c1c1c21e1f1e1e1d1e1d1d1e1e1d1d1d1d1d1dc0c21d1d1e6566671d1f1e1e1d1d1d1d1f1d1d1d1d1e1d1d1d1d1e1d1d1e1e1e1d1e1e1d1d1d1d1d1e1d1d1e9091
1e1d1d1d1dd0b4c1c1c21d1d1da41d5556565656571ea31d1db0c4c21d1d1d6566671d1d1d1d1e1d1d1e1e1d1e1e1d1d1d1d1e1d1d1d1d1d1e1e1d1d1d1e1e1d1d1d1d1d1d1d9091
81821e1d1d1ec0c1c1c21d1d1e1e1d6566666666671e1d1d1ec0c1c21d1d1e6566671d1d1d1f1e1e1d1e1e1d1d1d1d1d1d1d1d1d1f1d1f1e1f1e1e1e1d1f1d1d1e1e1d1d1d1d9091
91921e1d1e1dd0d1d1d21d1d1e1f1d6566666666671e1e1d1dd0b4c21d1d1d6566671d1d1f1d1d1d1d1e1d1d1d1d1e1d1d1d1d1d1d1d1e1d1e1d1d1d1d1d1e1d1d1e1d1d1d1d9091
91921d1d1d1e1e1d1d1d1e1d1da41d7576767676771da41d1d1dc0c21d1e1d6566671f1d1d1e1d1d1d1d1e1d1d1f1d1d1d1d1d1d1d1d1d1e1d1d1e1d1e1e1d1f1d1f1d1f1d1d9091
91921e1d1d1d1f1d1e1d1e1f1d1f1d1e1e1f1e1d1e1e1e1e1d1dc0c21d1d1f656666571d1d1e1d1d1d1d1d1e1d1e1d1d1d1e1d1d1d1d1d1e1e1d1d1d1d1d1e1f1d1d1e1d1f809491
9193821e1d1d1d1d1d1f1d1d1d1d1d1e1f1f1d1d1e1d1d1d1e1dc0c21d1d1e756666665656571d1d1d1f1d1d1d1d1d1d1e1f1e1d1d1e1d1d1d1f1e1d1d1f1d1d1d1d1f1e1d909191
91919381821e1d1d1e1e1e1d1d1d1f1d1db0b21f1e1d1f1db0b1c4c21d1e1f1d65666666666656571d1f1e1d1d1d1d1e1d1e1d1d1d1e1f1d1d1d1d1d1f1e1d1d1d1d1d1e1d909191
91919191921d1e1d1f1d1e1d1d1d1d1d1ec0c21f1d1d1e1dd0d1d1d21d1d1d1d75666666666666671d1d1d1d1d1f1f1f1d1e1d1d1d1d1d1f1d1e1d1e1e1d1d1d1f1d1d1d1e909191
91919191921da41f1f1e1dd31d1dd41e1dc0c21d1d1d1d1e1d1d1e1d1dd41d1d1d6566666666666656571e1d1f1d1d1d1d1d1f1e1d1d1e1e1e1f1e1f1d1d1d1d1d1d1d1d1da08491
91919191921d1d1d1d1e1e1d1d1d1d1d1ec0c3b21d1e1d1d1e1d1f1e1d1d1dd41e7576767676666666671e1d1d1d1d1d1e1e1e1d1d1d1f1f1d1e1d1d1d1d1d1d1d1d1d1d1d1e9091
91919183a21d1e1d1e1d1d1d1e1d1d1d1dc0c1c3b1b21f1e1d1e1d1d1e1e1d1d1d1d1d1d1d1e756666671d1d1d1e1e1d1e1d1e1d1d1e1d1d1e1e1d1f1e1d1e1d1e1d1d1d1d1f9091
91919192b0b1b1b1b1b1b1b1b1b1b1b1b1c4c1c1c1c3b1b1b1b1b1b21d1d1d1e1d1e1d1d1d1d1e6566671d1d1d1f1d1d1d1e1d1f1d1d1d1d1e1d1d1e1d1d1d1d1d1d1d1d1d1d9091
919183a2d0d1d1d1b4c1c1b3d1d1d1d1d1d1d1d1d1d1d1d1d1d1b4c21e1d1f1e1d1d1e1d1d1e1d6566671d1e1d1d1d1f1d1d1d1e1d1f1f1d1d1d1f1e1e1d1d1d1d1d1d1d1e1d9091
9183a21e1d1e1d1dc0c1b3d21d1e1e1d1d1d1f1d1e1d1e1e1d1dc0c21f1e1d1d1d1d1e1e1e1e1d6566671e1e1e1d1e1e1e1e1d1d1d1d1e1e1d1e1d1d1e1d1e1d1d1e1d1d1d1d9091
91921d1e1e1d1d1dd0d1d21f1d1d1d1e1d1d1e1d1d1d1e1d1d1dd0d21d1e1d1d1d1d1e1d1e1e1d3a3a3a1d1d1d1d1e1e1d1e1e1e1f1d1e1f1d1d1d1d1d1d1e1f1e1d1d1d1d1d9091
91921e1d1da31e1d1d1d1d1d1da41d1e1d80821d1d1e1d1d1d1d1e1d1d1d1d1e1d1d1d1d1d1e1d6566671d1d1e1e1d1d1f1d1e1e1d1d1d1e1d1d1e1d1e1e1d1e1d1f1d1f1f1d9091
91921d1d1d1d1d1d1d1d1d1d1e1d1e1d809493821d1d1e1e1f1e1d1e1d1d1e1d1d1f1d1f1e1d1d6566671d1d1f1e1d1d1d1d1e1d1d1d1e1d1d1d1e1d1e1d1e1d1d1d1e1d1d809491
83a21d1d1d1d1d1d1d1d1d1d1d1d1e1ea0a1a1a21d1e1e1f1e1e1d1d1d1d1d1e1d1d1e1d1d1d1d6566671e1d1d1d1e1d1d1d1d1e1d1d1d1d1d1e1d1d1d1f1d1f1d1f1d1e1f909191
921f1e1d1d1e1e1d1d1d1d1d1d1d1d1f1d1d1e1d1d1d1f1d1d1d1e1d1d1d5556565656565656566666671d1f1d1f1e1d1e1d1d1d1d1d1d1f1d1d1e1d1d1f1e1f1f1f1d1e1d909191
921d1d1e1d8586871e1d1d1d1d1e1d1d1f1d1e1e1d1d8586871d1d1d1f1d6566767676767676767676771d1d1d1d1d1e1f1e1d1d1f1e1d1e1d1d1d1d1d1e1d1d1e1d1e1d1d909191
921d1d1e1d958a978686868686868686868686868686958a971e1d1d1e1d65671d1d1e1d1e1d1e1d1d1d1e1d1e1d1e1d1d1d1d1e1d1d1d1d1d1e1d1d1d1d1e1d1d1d1e1d1d909191
921e1d1e1f95969796969696969696969696969696969596971d1d1d1e1d65671e1d1d1d1d1e1d1d1d1d1e1d1d1e1d1d1f1d1d1d1d1d1d1e1d1e1e1d1d1f1d1d1e1d1e1d1d909191
921e1e1f1e95969696969696969696969696969696969696971d1e1e1d1d65671d1e1d1e1f1d1d1d1d1e1d1d1d1d1d1e1d1d1f1d1e1d1d1d1d1d1d1d1d1d1d1e1d1d1e1f1d909191
93821d1e1d958a969696969696969696969696969696968a971e1d1f1d1e65671d1e1e1d1d1e1d1d1d1e1e1d1e1e1d1d1e1d1d1d1d1d1e1d1d1e1d1d1d1e1d1d1d1d1d1d1f909191
9193821e1f95969696969696969696969696969696969696971e1d1d1d1d65671d1e1d1d1d1e1e1e1d1d1d1d1d1d1d1e1d1d1f1d1d1d1d1d1d1d1e1d1d1d1d1d1e1e1d1d1d909191
9191921d1d95969696969696969696969696969696969696971d1d1e1e1d65671d1e1d1d1f1e1f1e1d1d1d1e1e1d1d1e1e1d1e1d1e1d1d1e1d1f1d1d1d1d1d1d1e1d1d1d80949191
919193821d958a969696969696969696969696969696968a971e1d1d1d1f65671d1e1e80818181818181818181818181818181818181821d1d1d1e1d1d1d80818181818194919191
919183a21e95969696969688a6a6a6899696969696969696971f1d1d1e1d65671d1d1e9083a1a1a1a1a1a1a18483a1a1a1a1a1a1a184921d1d1d1f1d1d1ea0a1a1a1a1a1a1a1a1a1
9191921d1e959696969696979a9b9c959696969696969696971d1d1d1d1d65671e1d1da0a21d252727281d1f909225272727281d1e90921e1da41d1ea31d1d1d1d1e1d1d1d1e1e1e
9191921e1d958a96969697a7aaabaca5959696969696968a971d1d1d1e1d65671d1d1d1d1d1e353237381f1ea0a235323736381d1d90921d1d1d1d1d1d1e1d1d1d1e1d1d1d1d1d1d
9191921d1d95969696969711111111119596969696969696971d1e1e1e1d65671f1d1d1e1d1e494a4a4a5a4a4a4a4a4a4b1d1f1d1f90921d1da31d1ea31d1e1e1d1d1d1d1f1e1d1e
9191921d1e95969696969711111111119596969696969696971e1d1d1e1d656780818181821d1d1d1d1f681d80821d1e1d1e1d1d1d90921f1e1d1d1d1d1e1e1d1e1d1d1f1d808181
9191921d1d958a979696971111111111959696969696958a971d1e1d1d1f656790919191921d1d1d1d1d681d90921d1e1d1d1e1d1ea0a21d1e1d1e1e1d1d1d1d1d1f1d1d1da08491
9191921e1d959697a6a6a71111111111a5a6a6a6a6a69596971d1d1d1d1d65679091919192252727281d681da0a21d1d1111111d1d1e1e1d1e1e1d1d1d1d1d1f1d1d1f1d1e1ea084
919193821ea5a6a71d1d1d1d1111111d1f1d1d1d1f1da5a6a71d1d1e1d1d65679091919192353732381e681e1d1d1d1d111111a31d1d1d1f1e1d1d1d1e1d1d1d1e1e1d1f1d1d1d90
919183a21d1d1d1d1d1d1d1d1d1d1d1d1f1d1d1d1e1d1d1d1e1d1d1d1d1d656790919191921d1e1e1d1d794a4a4a4a4b1111111d1d1d1d1d1e1d1d1e1d1d1d1d1d1d1d1f1d1d1d90
9191921d1d1e1e1d1e1e1e1d1d1d1d1f1d1d1d1e1d1d1d1e1d1d1d1f1f1e656790919191938181818181818181818181818181818181818181818181818181821d1d1d1d1d1e1e90
9191921e1d1f1f1d1e1d1e1d1e1d1d1e1d1d1d1e1d1d1e1e1d1d1d1f1d1d6567a0a1a1a1a1a1a1a1a1a1a1a1a1a1a1a1a1a1a1a1a1a1a1a1a1849191919191921d1d1e1d1f1d1d90
9191921d1d1d1d1d1e1d1d1d1e1d1e1e1f1f1d1d1d1d1d1d1d1e1d1d1d1e65671e1d1d1d1e1d1e1d1e1d1d1d1d1d1f1e1d1d1d1d1d1d1d1d1ea0a184919191921d1d1d1d1e1e1e90
9183a21d1d1d1f1e1f1f1d1d1d1d1d1d1d1e1d1d1d1d1d1f1d1f1d1d1d1d3a3a1d1e1d1d1d1d1d1e1d1d1e1d1e1d1f1d1d1d1d1d1d1e1e1e1d1d1da0a18491921d1d1e1d1e1f8094
91921d1e1d80818181818181818181818181821d1e1e1d1d1d1e1d1d1e1d65671e1e1f1e1d1d1d1d1d1d1d1d1e1d1d1e1f1d1e1d1e1d1d1f1e1e1d1e1da08493821d1d1f1d809491
91921d808194919191919191919191919191921f1d5556565656565656566666565656565656565656565656565656565656571d1d1d1d1d1d1f1d1d1d1d909193821d1e80949191
91921da0a1a1a1a1a1a1a1a1a1a1a1a1a1a1a21f1f6566667676767676767676767676767676767676767676767676766666671d1d1e1f1d1f1d1d1f1e1ea0a1a1a21d1da0a18491
91921e1f1f1d1d1d1e1e1d1d1d1d1d1d1d1d1e1d1d6566671e1e1e1d1d1e1f1d1d1d1e1d1d1d1f1e1d1d1d1d1d1d1d1d6566671d1e1d1d1f1e1e1e1e1d1d1d1d1d1d1d1d1d1d9091
91921d1d1e1d1d1f1d1e1d1e1e1d1d1d1d1f1e1d1d6566671d1d1e1e1d1d1e1e1d1d1d1e1d1d1e1d1e1d1e1d1f1d1d1e6566671e1d1e1d1e1d1d1d1e1e1d1d1e1d1e1d1d1d1d9091
91921d1d1e1d1e1d1e1d1e1d1d1d1d1e1d1d1e1d1d6566671d1e1d1d1d1e1e1d1d1d1e1d1d1d1d1d1d1d1d1e1d1f1d1d6566671d1d1d1d1e1d1e1e1d1d1d1e1d1d1f1e1f1f1d9091
9193821d1e1e1d1d80821d1e1d1d1e1e1d1d1e1d1e6566671d1d1d1e1d1e1e1d1d1f1d1d1d1e1d1d1e1d1d1e1e1e1d1f6566671e1e1e1d1d1d1d1d1d1d1e1e1e1d1d1e1d1d809491
9191921d1d1e1d1da0a21d1f1f1d1d1e1d1d1e1e1d6566671e1d1d1d1d1e1d1d1d1d1d1e1e1e1d1e1e1d1d1d1d1e1d1d6566671d1e1d1d1f1e1d1d1d1d1d1d1e1f1d1e1d1d909191
9191921e1d1d1e1d1d1d1d1d1d1e1d1d1d1d1e1e1d6566671d1d1e1d1d1d1d1d1d1e1d1e1e1d1d1d1d1f1f1d80818182656667808181818181821d1e1f1d1e1d1d1e1e1d80949191
919193821d1d1d1e1d1d1e1d1e1d1d1d1d8081818265666780818181821d1e808181821d1d1d1e1d1d1d1d8094919192656667909191919191938181821f1d1e1e1d1e8094919191
91919193821f1d1d1e1d1d1e1f1f1e1e8094919192656667909191919381819491919381821e1d1e808181949191919265666790919191919191919193821e1f1d1d809491919191
9191919193818181818181818181818194919191a2656667909191919191919191919191921e1d1d9091919191919192656667909191919191919191919381818181949191919191
