tilesheet=bgtiles
size=72 60
region=home
poi=49 42 START 0 0 0 
BEGIN_BODY
919191919191919191919191919191919191919183a1a1a1a1a1a1a1a1a1a26566679091919183a1a21d1d1ea0a1849191919191919183a1a1a1a184919191919191919191919191
91919191919183a1a1a1a1a1a1a1a1a1a1849183a21d1d1d1d1d1d1d1d1f1d656667a0a1a1a1a21e1e1d1e1d1d1ea0a1a1a1a1a1a1a1a21d1d1d1da0a1a1a1a18491919191919191
919183a1a1a1a21d1d1e1d1d1e1e1d1e1ea0a1a21d1e1d1d1d1d1d1d1d1d1d6566671d1e1e1e1d1d1d1d1d1d1d1d1e1d1d1d1d1d1e1e1e1d1e1d1d1e1e1d1e1ea0a1a1a184919191
9183a21d1d1d1d1d1d1d1d1e1d1d1d1e1d1d1d1e1f1d1d1e1d1e1f1d1d1d1d6566671d1d1d1d1d1d1d1d1d1e1d1e1d1d1d1d1d1d1d1d1e1d1e1d1e1d1e1f1d1d1d1e1d1da0849191
91921d1d1d1d1d1d1d1d1e1d1e1e1e1d1e1e1d1d1d1d1d1e1f1d1e1d1d1d1d6566671d1d1e1d1d1d1f1d1d1f1e1d1e1e1e1d1d1d1d1f1d1f1d1d1d1d1d1f1e1d1d1f1e1d1e909191
a1a21d1e1d1e1d1d1f1d1d1d1d1d1d1d1d1e1d1d1d1d1d1e1f1d1d1d1e1d1d6566671d1e1d1e1e1e1d1e1e1e1d1d1d1d1d1f1d1e1d1d1e1d1e1e1d1e1d1f1d1d1e1d1d1d1da08491
1e1f1d1d1d1e1d1e1e1e1d1d1d1d1d1d1e1d1e1f1e1e1d1d1d1e1d1d1d1f1d6566671d1e1d1d1e1d1d1f1d1d1d1e1d1d1d1d1e1d1e1d1f1d1d1d1e1d1d1f1e1f1e1d1d1d1e1f9091
1e1e1e1d1e1f1d1d1d1e1e1f1e1e1d1e1d1d1e1e1d1d1d1d1d1d1d1e1d1d1e6566671d1f1e1e1d1d1d1d1f1d1d1d1d1e1d1d1d1d1e1d1d1e1e1e1d1e1e1d1d1d1d1d1e1d1d1e9091
1e1d1d1d1d1e1d1f1d1d1d1d1d1d1d1d1d1d1d1d1e1e1d1d1d1e1e1d1d1d1d6566671d1d1d1d1e1d1d1e1e1d1e1e1d1d1d1d1e1d1d1d1d1d1e1e1d1d1d1e1e1d1d1d1d1d1d1d9091
81821e1d1d1e1d1e1d1d1d1d1e1e1d1d1d1d1e1e1d1e1d1d1e1d1f1d1d1d1e6566671d1d1d1f1e1e1d1e1e1d1d1d1d1d1d1d1d1d1f1d1f1e1f1e1e1e1d1f1d1d1e1e1d1d1d1d9091
91921e1d1e1d1e1d1d1d1d1d1e1f1d1d1e1e1e1d1d1e1e1d1d1e1e1d1d1d1d6566671d1d1f1d1d1d1d1e1d1d1d1d1e1d1d1d1d1d1d1d1e1d1e1d1d1d1d1d1e1d1d1e1d1d1d1d9091
91921d1d1d1e1e1d1d1d1e1d1d1d1d1d1d1e1d1f1e1d1d1d1d1d1d1d1d1e1d6566671f1d1d1e1d1d1d1d1e1d1d1f1d1d1d1d1d1d1d1d1d1e1d1d1e1d1e1e1d1f1d1f1d1f1d1d9091
91921e1d1d1d1f1d1e1d1e1f1d1f1d1e1e1f1e1d1e1e1e1e1d1d1d1e1d1d1f656666571d1d1e1d1d1d1d1d1e1d1e1d1d1d1e1d1d1d1d1d1e1e1d1d1d1d1d1e1f1d1d1e1d1f809491
9193821e1d1d1d1d1d1f1d1d1d1d1d1e1f1f1d1d1e1d1d1d1e1d1d1d1d1d1e756666665656571d1d1d1f1d1d1d1d1d1d1e1f1e1d1d1e1d1d1d1f1e1d1d1f1d1d1d1d1f1e1d909191
91919381821e1d1d1e1e1e1d1d1d1f1d1d1e1d1f1e1d1f1d1d1d1d1d1d1e1f1d75666666666656571d1f1e1d1d1d1d1e1d1e1d1d1d1e1f1d1d1d1d1d1f1e1d1d1d1d1d1e1d909191
91919191921d1e1d1f1d1e1d1d1d1d1d1e1f1d1f1d1d1e1d1d1d1d1d1d1d1d1d1d656666666666671d1d1d1d1d1f1f1f1d1e1d1d1d1d1d1f1d1e1d1e1e1d1d1d1f1d1d1d1e909191
91919191921d1d1f1f1e1d1d1d1d1e1e1d1d1d1d1d1d1d1e1d1d1e1d1d1d1d1d1d6566666666666656571e1d1f1d1d1d1d1d1f1e1d1d1e1e1e1f1e1f1d1d1d1d1d1d1d1d1da08491
91919191921d1d1d1d1e1e1d1d1d1d1d1e1e1d1d1d1e1d1d1e1d1f1e1d1d1d1d1e7576767676666666671e1d1d1d1d1d1e1e1e1d1d1d1f1f1d1e1d1d1d1d1d1d1d1d1d1d1d1e9091
91919183a21d1e1d1e1d1d1d1e1d1d1d1d1d1e1d1d1f1f1e1d1e1d1d1e1e1d1d1d1d1d1d1d1e756666671d1d1d1e1e1d1e1d1e1d1d1e1d1d1e1e1d1f1e1d1e1d1e1d1d1d1d1f9091
919191921e1d1d1d1e1d1d1d1e1d1d1e1d1e1e1e1d1d1e1d1d1e1d1e1d1d1d1e1d1e1d1d1d1d1e6566671d1d1d1f1d1d1d1e1d1f1d1d1d1d1e1d1d1e1d1d1d1d1d1d1d1d1d1d9091
919183a21f1e1e1d1d1e1d1e1d1e1f1d1d1d1e1d1d1d1d1d1d1f1d1d1e1d1f1e1d1d1e1d1d1e1d6566671d1e1d1d1d1f1d1d1d1e1d1f1f1d1d1d1f1e1e1d1d1d1d1d1d1d1e1d9091
9183a21e1d1e1d1d1e1d1d1d1d1e1e1d1d1d1f1d1e1d1e1e1d1d1d1e1f1e1d1d1d1d1e1e1e1e1d6566671e1e1e1d1e1e1e1e1d1d1d1d1e1e1d1e1d1d1e1d1e1d1d1e1d1d1d1d9091
91921d1e1e1d1d1d1d1d1d1f1d1d1d1e1d1d1e1d1d1d1e1d1d1d1e1e1d1e1d1d1d1d1e1d1e1e1d3a3a3a1d1d1d1d1e1e1d1e1e1e1f1d1e1f1d1d1d1d1d1d1e1f1e1d1d1d1d1d9091
91921e1d1d1e1e1d1d1d1d1d1d1d1d1e1d1d1d1d1d1e1d1d1d1d1e1d1d1d1d1e1d1d1d1d1d1e1d6566671d1d1e1e1d1d1f1d1e1e1d1d1d1e1d1d1e1d1e1e1d1e1d1f1d1f1f1d9091
91921d1d1d1d1d1d1d1d1d1d1e1d1e1d1d1e1d1d1d1d1e1e1f1e1d1e1d1d1e1d1d1f1d1f1e1d1d6566671d1d1f1e1d1d1d1d1e1d1d1d1e1d1d1d1e1d1e1d1e1d1d1d1e1d1d809491
83a21d1d1d1d1d1d1d1d1d1d1d1d1e1e1e1d1d1d1d1e1e1f1e1e1d1d1d1d1d1e1d1d1e1d1d1d1d6566671e1d1d1d1e1d1d1d1d1e1d1d1d1d1d1e1d1d1d1f1d1f1d1f1d1e1f909191
921f1e1d1d1e1e1d1d1d1d1d1d1d1d1f1d1d1e1d1d1d1f1d1d1d1e1d1d1d5556565656565656566666671d1f1d1f1e1d1e1d1d1d1d1d1d1f1d1d1e1d1d1f1e1f1f1f1d1e1d909191
921d1d1e1d1f1d1d1e1d1e1e1e1d1d1f1d1e1d1d1d1e1d1d1d1d1d1d1f1d6566767676767676767676771d1d1d1d1d1e1f1e1d1d1f1e1d1e1d1d1d1d1d1e1d1d1e1d1e1d1d909191
921d1d1e1d1d1d1d1e1d1d1d1d1e1d1d1f1f1d1d1f1d1e1d1e1e1d1d1e1d65671d1d1e1d1e1d1e1d1d1d1e1d1e1d1e1d1d1d1d1e1d1d1d1d1d1e1d1d1d1d1e1d1d1d1e1d1d909191
921e1d1e1f1e1d1d1d1d1d1d1d1d1d1e1d1d1d1d1d1e1e1d1d1d1d1d1e1d65671e1d1d1d1d1e1d1d1d1d1e1d1d1e1d1d1f1d1d1d1d1d1d1e1d1e1e1d1d1f1d1d1e1d1e1d1d909191
921e1e1f1e1d1e1d1d1d1e1d1f1e1d1d1d1e1d1f1d1d1d1d1d1d1e1e1d1d65671d1e1d1e1f1d1d1d1d1e1d1d1d1d1d1e1d1d1f1d1e1d1d1d1d1d1d1d1d1d1d1e1d1d1e1f1d909191
93821d1e1d1f1e1d1d1e1e1d1e1e1e1e1d1e1d1e1d1e1d1d1e1e1d1f1d1e65671d1e1e1d1d1e1d1d1d1e1e1d1e1e1d1d1e1d1d1d1d1d1e1d1d1e1d1d1d1e1d1d1d1d1d1d1fa08491
9193821e1f1d1d1d1d1d1d1d1d1d1d1d1d1e1d1d1e1f1f1d1d1e1d1d1d1d65671d1e1d1d1d1e1e1e1d1d1d1d1d1d1d1e1d1d1f1d1d1d1d1d1d1d1e1d1d1d1d1d1e1e1d1d1d1e9091
9191921d1d1d1d1d1d1d1d1e1d1d1f1f1d1f1d1e1e1d1d1d1d1d1d1e1e1d65671d1e1d1d1f1e1f1e1d1d1d1e1e1d1d1e1e1d1e1d1e1d1d1e1d1f1d1d1d1d1d1d1e1d1d1d1e1da084
919193821d1e1d1d1d1d1d1d1e1e1d1d1e1d1e1f1e1d1d1f1d1e1d1d1d1f65671d1e1e80818181818181818181818181818181818181821d1d1d1e1d1d1d1d1e1d1d1d1e1e1e1d90
919183a21e1d1d1d1e1d1e1d1e1e1e1d1e1f1e1e1d1d1e1e1f1f1d1d1e1d65671d1d1e9083a1a1a1a1a1a1a18483a1a1a1a1a1a1a184921d1d1d1f1d1d1e1e1f1e1d1d1d1d1e1da0
9191921d1e1d1e1d1d1d1e1d1e1e1f1d1d1e1d1f1d1d1d1f1e1d1d1d1d1d65671e1d1da0a21d252727281d1f909225272527281d1e90921e1da41d1ea31d1d1d1d1e1d1d1d1e1e1e
9191921e1d1d1e1d1d1d1d1d1e1e1d1f1e1e1d1d1d1d1d1d1f1d1d1d1e1d65671d1d1d1d1d1e353237381f1ea0a235323736381d1d90921d1d1d1d1d1d1e1d1d1d1e1d1d1d1d1d1d
9191921d1d1f1e1e1d1e1d1d1e1d1d1d1e1e1e1d1d1d1e1d1e1d1e1e1e1d65671f1d1d1e1d1e494a4a4a5a4a4a4a4a4a4b1d1f1d1f90921d1da31d1ea31d1e1e1d1d1d1d1f1e1d1e
9191921d1e1d1d1d1e1d1d1d1d1d1d1d1e1d1d1f1d1d1d1d1f1e1d1d1e1d65671d1e1e80821d1d1d1d1f681d80821d1e1d1e1d1d1d90921f1e1d1d1d1d1e1e1d1e1d1d1f1d1d1e80
9191921d1d1d1d1d1e1d1e1d1d1e1d1d1d1f1d1d1f1e1d1d1e1d1e1d1d1f65671e1e1d90921d1d1d1d1d681d90921d1e1d1d1e1d1ea0a21d1e1d1e1e1d1d1d1d1d1f1d1d1d1d1d90
9191921e1d1d1e1d1d1d1e1d1d1d1d1d1d1d1d1d1d1d1e1d1e1d1d1d1d1d65671f1e1d9092252727281d681da0a21d1d1d1d1d1d1d1e1e1d1e1e1d1d1d1d1d1f1d1d1f1d1e1e1e90
919193821e1e1d1d1d1d1d1d1d1e1e1d1e1e1d1f1f1e1d1d1d1d1d1e1d1d65671d1d1d9092353732381e681e1d1d1d1d1d1d1da31d1d1d1f1e1d1d1d1e1d1d1d1e1e1d1f1d1d1d90
919183a21d1d1d1d1d1d1d1d1d1d1d1d1f1d1d1d1e1d1d1d1e1d1d1d1d1d65671d1f1d90921d1e1e1d1d794a4a4a4a4b1d1d1d1d1d1d1d1d1e1d1d1e1d1d1d1d1d1d1d1f1d1d1d90
9191921d1d1e1e1d1e1e1e1d1d1d1d1f1d1d1d1e1d1d1d1e1d1d1d1f1f1e65671e1d1e90938181818181818181818181818181818181818181818181818181821d1d1d1d1d1e1e90
9191921e1d1f1f1d1e1d1e1d1e1d1d1e1d1d1d1e1d1d1e1e1d1d1d1f1d1d65671d1d1ea0a1a1a1a1a1a1a1a1a1a1a1a1a1a1a1a1a1a1a1a1a1849191919191921d1d1e1d1f1d1d90
9191921d1d1d1d1d1e1d1d1d1e1d1e1e1f1f1d1d1d1d1d1d1d1e1d1d1d1e65671e1d1d1d1e1d1e1d1e1d1d1d1d1d1f1e1d1d1d1d1d1d1d1d1ea0a184919191921d1d1d1d1e1e1e90
9183a21d1d1d1f1e1f1f1d1d1d1d1d1d1d1e1d1d1d1d1d1f1d1f1d1d1d1d65671d1e1d1d1d1d1d1e1d1d1e1d1e1d1f1d1d1d1d1d1d1e1e1e1d1d1da0a18491921d1d1e1d1e1f8094
91921d1e1d80818181818181818181818181821d1e1e1d1d1d1e1d1d1e1d65671e1e1f1e1d1d1d1d1d1d1d1d1e1d1d1e1f1d1e1d1e1d1d1f1e1e1d1e1da08493821d1d1f1d809491
91921d808194919191919191919191919191921f1d5556565656565656566666565656565656565656565656565656565656571d1d1d1d1d1d1f1d1d1d1d909193821d1e80949191
91921da0a1a1a1a1a1a1a1a1a1a1a1a1a1a1a21f1f6566667676767676767676767676767676767676767676767676766666671d1d1e1f1d1f1d1d1f1e1ea0a1a1a21d1da0a18491
91921e1f1f1d1d1d1e1e1d1d1d1d1d1d1d1d1e1d1d6566671e1e1e1d1d1e1f1d1d1d1e1d1d1d1f1e1d1d1d1d1d1d1d1d6566671d1e1d1d1f1e1e1e1e1d1d1d1d1d1d1d1d1d1d9091
91921d1d1e1d1d1f1d1e1d1e1e1d1d1d1d1f1e1d1d6566671d1d1e1e1d1d1e1e1d1d1d1e1d1d1e1d1e1d1e1d1f1d1d1e6566671e1d1e1d1e1d1d1d1e1e1d1d1e1d1e1d1d1d1d9091
91921d1d1e1d1e1d1e1d1e1d1d1d1d1e1d1d1e1d1d6566671d1e1d1d1d1e1e1d1d1d1e1d1d1d1d1d1d1d1d1e1d1f1d1d6566671d1d1d1d1e1d1e1e1d1d1d1e1d1d1f1e1f1f1d9091
9193821d1e1e1d1d80821d1e1d1d1e1e1d1d1e1d1e6566671d1d1d1e1d1e1e1d1d1f1d1d1d1e1d1d1e1d1d1e1e1e1d1f6566671e1e1e1d1d1d1d1d1d1d1e1e1e1d1d1e1d1d809491
9191921d1d1e1d1da0a21d1f1f1d1d1e1d1d1e1e1d6566671e1d1d1d1d1e1d1d1d1d1d1e1e1e1d1e1e1d1d1d1d1e1d1d6566671d1e1d1d1f1e1d1d1d1d1d1d1e1f1d1e1d1d909191
9191921e1d1d1e1d1d1d1d1d1d1e1d1d1d1d1e1e1d6566671d1d1e1d1d1d1d1d1d1e1d1e1e1d1d1d1d1f1f1d80818182656667808181818181821d1e1f1d1e1d1d1e1e1d80949191
919193821d1d1d1e1d1d1e1d1e1d1d1d1d8081818265666780818181821d1e808181821d1d1d1e1d1d1d1d8094919192656667909191919191938181821f1d1e1e1d1e8094919191
91919193821f1d1d1e1d1d1e1f1f1e1e8094919192656667909191919381819491919381821e1d1e808181949191919265666790919191919191919193821e1f1d1d809491919191
9191919193818181818181818181818194919191a2656667909191919191919191919191921e1d1d9091919191919192656667909191919191919191919381818181949191919191
