tilesheet=mtntiles
size=36 20
region=caves
poi=22 17 START 0 0 0 
poi=23 13 SPRITE 0 0 0 pushbox
poi=22 11 SPRITE 0 0 0 statue_gamma
poi=21 7 SPRITE 0 0 0 statue_lambda
poi=35 19 EDGE_DOOR 255 238 0 home
poi=20 5 DOOR 13 19 0 caves_1
poi=15 8 SPRITE 0 0 0 pushbox
BEGIN_BODY
135051515151515230313250515151515220135556573131313131313131313131313114
226044434453536226272860535454546220226566670006030203030100070500000020
227071717171717236373870717171717220227576770300000101000506020004000520
220602000200010336373806000003050020220401050005000000010200000301020120
222627272727272737373807001011111124231111111111111111120104000100040120
223637474747474747474801002013313131313140313131313114220102000300000620
223638010105000007000101012022050001030203072627280420220202070006020320
223638040000000000000210123032000004010602004647480320220302010503020020
223638010105000702040030320504001011111112010401010220220201010600010020
223638010000010010120000000110112421212123120310111124220100030600030420
223638060201000530320201000030313114133131320430313114220703050300030020
223638040205010102030400000101060320220402010001000520220400010203010020
223638030400020003040405020207050520220734343333330020220401050200050120
223638000201040001040700070002000620220102000400000420220102020101000020
223638040300000105040004010306000320220304021011111124220300000502010120
223638030100030503010606000506000330320002003031313131320301010304010020
223638060202030302020301020107050004040500000003010201010601000301040020
223637272727272727272727272728010001040001050707030000000000000000030220
224647474747474747474747473737280004000600000005000307010206010100000420
231111111111111111111111123637381011111111111203040210111111111111111124
