tilesheet=bgtiles
size=27 15
poi=13 11 START

BEGIN_BODY
404040404040404040404040404040404040404040404040404040
400808080808080808080808080808080808080808080808080840
400808080808080808080808080808080808080808080808080840
400808080808080808080808080808080808080808080808080840
400808080808080808080808080808080808080808080808080840
400808080808080808080808080808080808080808080808080840
400808080808080808080840404008080808080808080808080840
400808080808080808080840080808080808080808080808080840
400808080808080808080840084008080808080808080808080840
400808080808080808080808080808080808080808080808080840
4008080808080808080000000808080f0f0f080808080808080840
4008080808080808080000000808080f0f0f080808080808080840
4008080808080808080000000808080f0f0f080808080808080840
400808080808080808080808080808080808080808080808080840
404040404040404040404040404040404040404040404040404040
