tilesheet=bgtiles
size=27 15
poi=13 11 START 0 0 0 
poi=11 8 DOOR 6 2 0 cave002
poi=0 0 EDGE_DOOR 255 247 0 spring
BEGIN_BODY
514242424242436566666741424242424242424242424242424253
601d1f1d1e1e1d656666671f1f1e1d1d1f1d1d1d1d1f1d1d1f1f60
601e1d1f1e1d5566666666571f1f1e1f1d1d1f1f1d1d1e1e1f1e60
601d1e1d5855666666666666571f1f1e1d1f1e1d1f1f1f1e1f1f60
601d1d1f6865666666666666671d1f1e1e1f1d1e1e1e1d1d1e1f60
601e1d1e6865666666666676771d1f1e1e1f1f1e1d1d1f1f1e1f60
601f1d1d687576767676775142431d1e1d1e1d1d1d1f1f1f1d1f60
601f1e1d794a5a4a4a4b51731e1e1d1f1e1d1d1e1d2a1e1e1e1e60
601d1f1e1e1d681e1f1e60291d401d1e1e1d1e1f1e1d1d1d1e1f60
601f1d1f1e1d681e1e1f61531f1e1d1f1f1d1f1e1d1e1d1d1e1e60
601e1d1e1d1e681d1f1e71731f1e1d1d1f1f1d1f1d1f1e1d1f1e60
601d1f1f1d1f681e1d1d1f1e1e581d1e1f1e1f1e1f1f1d1f1f1e60
601f1e1f1d1d681f1e1d1e1e1e681f1d1e1e1f1d1e1d1d1d1f1f60
601f1e1f1e1d794a4a4a4a4a4a7b1e1e1f1d1d1d1e1d1f1e1d1e60
714242424242424242424242424242424242424242424242424273
